NO ./assets/textures/north.xpm
SO ./assets/textures/south.xpm
WE ./assets/textures/west.xpm
EA ./assets/textures/east.xpm

F 20,20,20                      
C 40,40,45  

111111111111111111111111111111111
100000000011111000000000111111111
101111111000000111111100000000001
101000001011111100000111111111101
101011101010000000000000000000101
101011101011111111111111011110101
101000001000000000000000010000101
101111111011111111111111110111101
100000000010000000000000000000001
111110111110111111111111111111001
100000100000100000000000000000001
101110111110111011111111111111111
101000000000001010000000000000001
101111111111111011111111111111101
1000000N0000000000000000000000001
101111111111111011111111111111101
101000000000001010000000000000001
101110111110111011111111111111111
100000100000100000000000000000001
111110111110111111111111111111001
100000000010000000000000000000001
101111111011111111111111110111101
101000001000000000000000010000101
101011101011111111111111011110101
101011101010000000000000000000101
101000001011111100000111111111101
101111111000000111111100000000001
100000000011111000000000111111111
111111111111111111111111111111111