NO ./assets/textures/north.xpm
SO ./assets/textures/south.xpm
WE ./assets/textures/west.xpm
EA ./assets/textures/east.xpm
F 20,20,20
C 200,200,200

11111111111111
10000000000001
10111011101101
10100010001001
10111011101101
10000000000001
10111011101101
1000N000000001
11111111111111