NO ./assets/textures/north.xpm
SO ./assets/textures/south.xpm
WE ./assets/textures/west.xpm
EA ./assets/textures/east.xpm
F 20,20,20
C 200,200,200

11111111111111
10001111100001
10111000111101
10111011101101
10111000111101
10001111100001
10111000111101
1000N000000001
11111111111111